WE                      ./textures/acacia_leaves.xpm         


SO ./textures/jungle_leaves.xpm    


NO        		./textures/spruce_leaves.xpm    






EA    			./textures/oak_leaves.xpm 			 

C	 255,255       ,  255 

F      131, 1   ,3         
    


111111111111111111111
100000000000000000001
100000000000010000001
100000000000000000001
100000011100000000001
100000001000000000001
100000000000000000001
111111111111000000001
100000000E00000000001
111111111111111111111
