SO	./textures/bluestone.xpm 
NO	./textures/redbrick.xpm 
EA	./textures/wood.xpm 
WE	./textures/greystone.xpm 

F	10, 200, 200
C	30, 100, 220

      111111111111111111111
     10000000000000000000001
    1000000000000000000000001
   100000000000000000000000001
  10000000000100100100000000001
 100000000000001 100000000000001111111111111111111111111 
100000000000101   10100000000000000000000000000000000001 
 100000000000001 100000000000001111111111111111111111101 
  10000000000100100100000000001        1111111       101 
   100000000000000000000000001         10000011111111101 
    1000000000000000000000001          10000000000000001 
     10000000000000000000001           10000011111111101 
      111111110000011111111            1111111       101 
      1000000000N000000001111111111111111111111111111101 
      10000000000000000000000000000000000000000000000001 
      11111111111111111111111111111111111111111111111111
